####################################################################################################
#                                                                                                  #
#                                                                                                 .#
# ...........,,......,,.................,,...............,,.........,,.............,,..............#
#.                                                                                                ,#
#.                                                                                          .     ,#
#.                                    ,                                                           ,#
#,       #################                     ## ,      ......   , ##############                ,#             
#               ##     ##             ,        ##   ,     .....            #      #               ,#                      
#             ###########                      ##     ,      ..           #########               ,#
#               ## .                           ##       ,       ......                            ,#
#               ##        .                    ##          ,                                      ,#
#               ###########        .  #                                         ........          ,#
#                          ,       .  #                      #                                    ,#
#                          ,       .  #                      #                                    ,#
#              . ......    ,        .  #                      #########################           ,#
#             #            ,        .  #                                   ##        ##           ,#
#             #  .......   ,                                               ##        ##           ,#
#             ###################                                       ##############            ,#
#                      ##        ##                                      ,  .    . ,              ,#
#                      ##        ##             #                        ,     .    ,             ,#
#                      ##        ##             #                          ,  .  ,                ,#               
#                    ##############             #                             ,                   ,#
#                      ##         ##            ############                                      ,#
#                      ##########                           #              #########              ,#
#                                                           #                                     ,#
#                                                           #                                     ,#
#                                                                                                 .#
#                                                                                                 .#
#                                                                                                 .#  
# ..............,,,...................,,.................,,.................,,.................... #                                                                                              
####################################################################################################